quiz.properties|name=Advanced 1~~q_lang=en-US~~a_lang=ru-RU~~fontsize_q=40~~fontsize_a=40
Neither here nor there|Ни то, ни се
with flying colours|с большим успехом/с победой
carry all before oneself|добиться успеха и победить всех соперников
get brownie points|отличиться/заработать благодарность или вознаграждение/заслужить похвалу
pull oneself up by one's bootstraps|самому добиться успеха, пробить себе дорогу
go off the boil|становиться спокойнее (о ситуации)
sweep the board|добиться полного успеха/стать хозяином положения
have smth under one's belt|иметь на счету\ в прошлом, за плечами
Firing on all cylinders|работать на всю катушку
act in cold blood|хладнокровно действовать
make up one's mind|решиться
subscribe to the theory that|придерживаться мнения о том, что
Have a point!|говори по сути!
A friend in need is a friend indeed|Друг познается в беде.
A hedge between keeps friendship green|смысл пословицы: когда между друзьями некая дистанция, то и дружба прочнее.
A friend's frown is better than a foe's smile|Лучше горькая правда друга, чем лесть врага. Недруг поддакивает, а друг спорит.
A cracked bell can never sound well|Треснутый колокол не сможет никогда хорошо звенеть. Русский эквивалент: Надсаженный конь, надломленный лук да замирённый друг равно ненадежны.
fondest wish|заветное желание
twice told tale|старая история, баян
out of harm's way|от греха подальше
unconditionally|безоговорочно
furthermore|1 тогда; 2 потом, затем; 3 в таком случае, тогда; 4 кроме того, к тому же;
pursuant to|в соответствии с
mindful of|помня о
have a soft spot for someone|иметь слабость к кому-л. Mark has a soft spot for Lucy.
go steady|встречаться с кем-либо~~~~They’ve been going steady for a year now!
love cannot be compelled|насильно мил не будешь
cupboard love|корыстная любовь, любовь с расчётом
calf love|детская влюблённость, юношеское увлечение
draw your attention to|привлечь ваше внимание к тому что
take the liberty of|взять на себя смелость
COME HELL OR HIGH WATER|что бы ни случилось
WATER UNDER THE BRIDGE|прошлого не вернешь (I can see how upset you are because of the divorce, but it is water under the bridge now and you can’t do anything about it.)
fork out|раскошелиться
Suit yourself|Как хочешь. Воля ваша. Делай, как знаешь.
No sweat|без проблем; это не трудно!
Top hole!|очень хорошо; великолепно; превосходно; отлично
To the best of my belief|насколько мне известно
To all intents and purposes|фактический; по сути; в конечном итоге
That’s the right spirit!|это как раз то, что нужно!; вот молодец!
Not by a great deal!|ни за что!; ни в коем случае!
Tell that to the marines!|расскажи это кому-нибудь другому!; ври побольше!
Take it or leave it|на ваше усмотрение; как хотите
rip off|грабить, сдирать, воровать
sit on a powder keg|жить как на вулкане
Get your skates on!|Пошевеливайся!
A white-knuckle ride|Крайне нервозная поездка или аттракцион (всю дорогу сидишь как на иголках)
catch smbd red-handed|поймать кого-то с поличным
paint the town red|уйти в загул
as a babe at the woods|словно с луны свалившись
at sixes and sevens|куча-мала,кто в лес кто-по дрова, беспорядок
a happy medium|золотая середина
snake in the grass|скрытая опасность; скрытый враг; предатель, змея подколодная
bottle up|сдерживать, скрывать (негодование, обиду)
on the spur of the moment|под влиянием момента
make a living|зарабатывать на жизнь
lucky break|счастливый случай
loosen up|расслабиться, раскрепоститься
get through|1 проходить, проникать через; 2 выдержать, справиться
put on airs|вести себя высокомерно
run of luck|полоса удачи
ease up|сбавить тон, обороты; замедлять(ся)
have a screw loose|спятить (крыша поехала)
let the cat out of the bag|выдать секрет, проболтаться
see daylight|видеть выход из положения
put by|1 откладывать (деньги); 2 избегать (разговора)
cry wolf|поднимать ложную тревогу ( от басни Эзопа The Boy Who Cried Wolf)
hear/to know from the horse's mouth|слышать/знать из первых уст
bark the wrong tree|напасть на ложный след, обратиться не по адресу ( досл. лаять не на то дерево)
call a spade a spade|называть вещи своими именами
make a mountain out of a molehill|делать из мухи слона
get smbd's goat|раздражать, сердить к.-л.
break the ice|растопить лед, начать разговор. общение
straight away/off|незамедлительно
pull the other one|расскажи это кому-нибудь другому
a likely story|типичная история(недоверие)
take something with a pinch of salt|относиться недоверчиво
give someone the benefit of the doubt|поверить, что кто-либо прав или не виновен в чем-либо
fundamental tenet|основной принцип
implausible|невероятный, невозможный
plausible pretext|благовидный предлог
ingenious|изобретательный, находчивый, искусный
incredulous|недоверчивый, скептический
eradicate|истребить, вырывать с корнем
narrow-minded bigotry|узколобость
bigoted|нетеримый, фанатический
reactionary|противодействующий
conversion|превращение, переход(в какую-л. веру)
adherent of|приверженец, сторонник
adhere to|поддерживать
adherence|приверженность
rigid adherence to rule|строгое соблюдение правил
slack-jawed|разинув рот
single-minded|целенаправленный
sourpuss|вечно недовольный
rip-roaring|подвижный,живой
flunky|слишком послушный человек
obedient|покорный
fraudster|мошенник
lily-livered|трусливый
unscrupulous|бессовестный
obstinate|упрямый
conscientious|добросовестный
gullible|доверчивый
unapproachable|необщительный, недоступный
disdainful|презрительный
haughtiness|высокомерие
diffident|неуверенный в себе
garrulous|болтливый
effusive|несдержанный
impulsive|спонтанный
impetuous|порывистый (негативное значение)
gait|походка, поступь
leer|косой, плотоядный взгляд
scowl|смотреть сердито,хмурится
paut|надутые губы/надувать губы
haggard|изможденный изнуренный
sallow|желтоватый, болезненный
swarthy|смуглый, темный
never a hair out of place|аккуратный, расчесанный
scruffy|грязный, неряшливый
Unkempt|Нечесаный, неряшливый
corpulent|дородный, полный, тучный, жирный
stout|1 плотный, полный, тучный; 2 крепкий, прочный
portly|тучный
gangling|нескладный
lanky|долговязый; худой и тощий
scrawny|костлявый
trite|банальный, избитый
squalid|грязный, нищенский
puerile|ребяческий, незрелый, легкомысленный
pretentious|вычурный, надменный
ostentatious|показной, хвастливый
officious|назойливый, вмешивающийся не в свои дела
offhand|бесцеремонный, неуважительный
obsequious|подобострастный, раболепный
nit-picking|придирчивость
fickle|непостоянный, ненадежный
dowdy|неряшливо или безвкусно одетая женщина
brash|дерзкий, наглый
bland|безвкусный,банальный
repulsion|антипатия
revolt|чувствовать отвращение
revulsion|отвращение
scorn|пренебрежение, презрение
abhorrence|отвращение,омерзение
loathe|питать отвращение
loathsome|тошнотворный
to be not averse to|быть непрочь
pet aversion|особая антипатия
to be on cloud nine|быть на 7-м небе от счастья
covetous|жадный до чужого богатства
fly into a tantrum|прийти в бешенство
floating/walking on air|парить в облаках от счастья
feel on top of the world|чувствовать себя на вершине мира
thrilled to bits|быть в восторге
full of the joys of spring|переполненный оптимизмом и энергией
rapture|восторг, выражение восторга, экстаз
jubilant|ликующий ( особенно после победы)
exultant|торжествующий
implacable|непримиримый
conciliatory|примирительный
placatory|умиротворяющий
defuse the tension|разрядить волнение
covet|сильно желать
yearn for|томиться, тосковать
thirst/hunger for|иметь жажду к
hanker after|страстно желать, особенно то , что не можешь иметь
crave for|страстно желать, жаждать; тосковать (о чём-л.)
to be on bad terms with smn|иметь плохие отношения с кем-л
hate someone's guts|ненавидить кого-то
see eye to eye|сходиться во взглядах
discord|разногласие, вражда
rift|размолвка, разлад
genuine misunderstandings|разногласия
staunch|стойкий, верный
unswerving|непоколебимый
get the hang of|понять
breeze through the exam|легко сдать экзамены
fall behind with|отставать
rote learning|обучение методом заучивания
learn off|учить наизусть
cramming|зубрежка
peripatetic teacher|внештатный учитель
supply teacher|временный заместитель учителя
indispensable|1) обязательный, не допускающий исключений (о правиле) 2) важный, необходимый
endow|обеспечивать постоянным доходом, наделенный, одаренный
considerate|внимательный к другим, деликатный, тактичный
consideration|вежливость, уважение
bosom friend|закадычный друг
hit it off|найти общий язык
besotted|одержимый, влюбленный
infatuated|влюбленный до безумия
terse|резкий, грубый
brusque|отрывистый, резкий; обходиться грубо, бесцеремонно (с кем-л.)
chivalrous|вежливый, рыцарский
tight-fisted|скупой
lowbrow|неинтеллектуальный
sober|рассудительный, трезвый
astute|проницательный
shrewd|сообразительный
parsimonious|бережливый, экономный
mulish|упрямый
immoderate|несдержанный
frugal|экономный
thrifty|бережливый
dogged|настойчивый
resolute|непоколебимый, решительный, твёрдый
unscrupulous|бессовестный
faultfinder|критикан, придира
morose|замкнутый, сердитый
shrewd|сообразительный, быстро и легко схватывающий
placid|мирный
diligently|усердно, старательно
stingy|скупой, прижимистый
sagacious|проницательный, мудрый
obliging|любезный, услужливый
opportunistic|предприимчивый, меркантильный
