quiz.properties|name=Character~~q_lang=en-US~~a_lang=ru-RU~~fontsize_q=40~~fontsize_a=40
Absent-minded|рассеянный
Ambitious|честолюбивый
Appealing|обаятельный
Assertive|напористый
Attractive|привлекательный
Audacious|нахальный
Awkward|неуклюжий
Behaviour|поведение
Blockhead|тупица
Boastful|хвастливый
Bold|смелый
Bore|зануда
Bright|способный, умный
Calm|спокойный
Charitable|благотворительный
Chatter-box|болтун
Cheerful|весёлый
Clever|умный
Clumsy|неуклюжий
Communicative|общительный
Compelling|неотразимый
Conceited|тщестлавный
Conscientious|добросовестный
Consistent|последовательный
Coward|трус
Cruel|жестокий
Cultural|образованный
Cunning|хитрый
Dawdler|копуша
Decent|порядочный
Diligent|прилежный
Docile|послушный
Double-faced|двуличный
Earnest|ревностный
Eloquent|красноречивый
Envious|завистливый
Fair|справедливый
Faithful|верный
Fearful|пугливый
Frank|откровенный
Generous|щедрый
Gentle|кроткий
Good-natured|добродушный
Greedy|жадный
Haughty|надменный
Honest|честный
Hot-tempered|вспыльчивый
Humour|настроение, юмор
Ill-mannered|невоспитаный
Impudent|нахальный
Industrious|работоспособный
Irritable|раздражительный
Jealous|ревнивый
Just|справедливый
Lazy|ленивый
Lazy-bones|лентяй
Liar|лжец
Light-minded|легкомысленный
Loyal|верный
Mean|низкий
Modest|скромный
Mood|настроение
Naughty|капризный
Neat|опрятный
Neat|опрятный
Noble|благородный
Obedient|послушный
Obstinate|упрямый
Opinion|мнение
Outstanding|выдающийся
Persistent|настойчивый
Persuasive|убедительный
Polite|вежливый
Punctual|пунктуальный
Reasonable|благоразумный
Relaxed|раскованный
Reputation|репутация
Reserved|сдержаный
Resolute|решительный
Respectful|почтительный
Rude|грубый
Self-assured|самоуверенный
Self-starter|инициативный
Selfish|эгоистичный
Sentimental|сентиментальный
Shy|застенчивый
Slacker|лодырь
Sleepyhead|соня
Slippery|скользкий тип
Sloven|неряха
Sluggish|медлительный
Sly|хитрый, лицемерный
Smart|остроумный
Sophisticated|изощрённый
Steady|степенный
Stingy|скупой
Strong-willed|волевой
Sweet-tooth|сладкоежка
Tactful|тактичный
Temper|темперамент, нрав
Touchy|обидчивый
Trait|черта характера
Trusting|доверчивый
Unobtrusive|ненавязчивый
Versatile|разносторонний
Weak-willed|слабовольный
Well-bred|благовоспитанный
Wise|мудрый
Witty|находчивый
