Как добавить тему|how2add-ru.html
Аэропорт(airport)|airport.psv.txt
Животные(animals)|Animals.psv.txt
Комната ребенка(baby's room)|Babysroom.psv.txt
Ванная(bathroom)|bathroom.psv.txt
Спальня(bedroom)|bedroom.psv.txt
Тело(body)|body.psv.txt
Машина(car)|car.psv.txt
Характер(character)|character.psv.txt
Кино(cinema)|Cinema.psv.txt
Город(city)|city.psv.txt
Косметика(cosmetics)|Cosmetics.psv.txt
Жильё(dwelling)|Dwellingy.psv.txt
Образование(education)|Education.psv.txt
Защита окр среды(env protection)|EnvironmentProtection.psv.txt
Семья(family)|family.psv.txt
Флора(flora)|Flora.psv.txt
Еда(food)|Food.psv.txt
Уборка(home cleaning)|HomeCleaning.psv.txt
Отель(hotel)|Hotel..psv.txt
Болезни(illnesses)|illnesses.psv.txt
Кух Утварь(kitchenware)|Kitchenware.psv.txt
Закон(law)|Law.psv.txt
Медицина(medicalaid)|Medicalaid.psv.txt
Музыка(music)|Music.psv.txt
Профессии(professions)|professions.psv.txt
Транспорт(transport)|PublicTransportation.psv.txt
Школа(school)|school.psv.txt
Погода(weather)|SeasonsWeather.psv.txt
Общество(society)|society.psv.txt
Спорт(sport)|sport.psv.txt
Канцтовары(stationary)|Stationery.psv.txt
Театр(theater)|theater.psv.txt
Слова №1 (Words-1)|newwords1.psv.txt
Время(timeperiods)|timeperiods.psv.txt
Глаголы 1(verbs-1)|verbs1.psv.txt
Фантастика(Fantasy)|fantasy.psv.txt
Слова любви(Love words)|love.psv.txt
Продвинутый 01(Advanced 01)|Advanced01.psv.txt
TOEFL 01|toefl01.psv.txt
TOEFL 02|toefl02.psv.txt
Продвинутый 02(Advanced 02)|Advanced02.psv.txt